milk - молоко
hill - холм
kid - козленок
pig - поросенок
wind - ветер
dog - собака
box - коробка
fox - лиса
doll - кукла
frog - лягушка
pond - пруд
troll - троль
lorry - грузовик
bus - автобус
sun - солнце
jug - кувшин
cup - чашка
mug - кружка
bed - кровать
tent - палатка
bell - колокольчик
belt - ремень
egg - яйцо
nest - гнездо
net - сачок
desk - стол
pen - ручка
zero - ноль
one - один	
two - два
three - три
four - четыри
five - пять
six - шесть
seven - семь
eight - восемь
nine - девять
tent - десять
eleven - одиннадцать
twelve - двенадцать
thirteen - тринадцать
fourteen - четырнадцать
fifteen - пятнадцать
sixteen - шестнадцать
seventeen - семнадцать
eighteen - восемнадцать
nineteen - девЯтнадцать
twenty - двадцать
thirty - тридцать
forty - сорок
fifty - пятьдесят
sixty - шестьдесят
seventy - семьдесят
eighty - восемьдесят
ninety - девяносто
hundred - сто
thousand - тысяча
elf - эльф
shop - магазин
ship - корабль
fish - рыба
dish - блюдо
shelf - полка
sheep - овечка
cat - кошка
cap - кепка
ant - муравей
bag - сумка
lamp - лампа
van - фургон
map - карта
hat - шляпа
cock - петух
clock - часы
sock - носок
duck - утка
black - черный
red - красный
green - зеленый
book - книга
hook - крючок
wood - лес
big - большой
little - маленький
bench - скамейка
chimp - обезьяна
chick - цыпленок
cherry - вишня
match - спичка
good - хороший
bad - плохой
sad - грустный
happy - радостный
funny - смешной
car - машина
star - звезда
park - парк
door - дверь
farm - ферма
port - порт
horse - лошадь
floor - пол
queen - королева
quilt - одеяло
i - я
he - он
she - она
we - мы
they - они
our - наш
your - твой
it - оно
them - им
mum - мама
granny - бабушка
grandad - дедушка
name - имя
game - игра
cake - торт
lake - озеро
plane - самолет
plate - тарелка
rose - роза
stone - камень
bone - кость
phone - телефон
boat - лодка
coat - пальто
old - старый
cold - холодный
blue - синий
tulip - тюльпан
pupil - ученик
student - студент
cute - милый
bike - велосипед
kite - змей
pilot - пилот
pie - пирог
sky - небо
my - мой
fly - муха
brother - брат
mother - мама
father - папа
throne - трон
thick - толстый
thin - тонкий
sister - сестра
bird - птица
girl - девочка
birch - береза
nurse - медсестра
turtle - черепаха
purple - фиолетовый
mermaid - русалка
servant - слуга
fern - папоротник
apple - яблоко
plum - слива
lemon - лимон
banana - банан
grape - виноград
orange - апельсин
ride - ездить
make - делать
me - мне
take - брать
his - его
her - ее
pencil - карандаш
twig - ветка
hen - курица
visit - посещать
send - посылать
find - найти
help - помогать
this - это
these - эти
that - тот
those - те
rat - крыса
mat - коврик
fat - толстый
dish - блюдо
stick - палка
tea - чай
meat - мясо
seal - тюлень
please - пожалуйста
see - видеть
eat - кушать
read - читать
live - жить
life - жизнь
write - писать
well - хорошо
sea - море
say - говорить
high - высоко
low - низко
silly - глупый
clever - умный
bye - пока
with - с
white - белый
sail - плавать
tall - высокий
small - небольшой
nice - хороший
sofa - диван
nose - нос
snow - снег
ropa - веревка
snowball - снежок
snowman - снеговик
today - сегодня
yesterday - вчера
tomorrow - завтра
go - идти
winter - зима
spring - весна
summer - лето
autumn - осень
january - январь
february - февраль
march - март
april - апрель
may - май
june - июнь
july - июль
august - август
september - сентябрь
october - октябрь
november - ноябрь
december - декабрь
eye - глаз
so - такой
carrot - морковка
sing - петь
bring - приносить
log - бревно
tag - салки
hide - прятаться
seek - искать
hopscotch - классики
skip - скакать
chess - шахматы
tennis - теннис
hockey - хоккей
hot - горячий 
cold - холодный 
hot - жарко
late - поздно
fine - хорошо
long - длинный
her - ее
what - что
where -где
why - почему
when - когда
how - как 
friend - друг
dress - одежда
cage - клетка
yellow - желтый
often - часто
give - давать
then - затем
goat - коза
boy - мальчик
toy - игрушка
noisy - шумный
break - ломать
daddy - папочка
clean - чистый
again - снова
suit - костюм
suitcase - чемодан
computer - компьютер
use - пользоваться
juice - сок
look - смотреть
spoon - ложка
moon - луна
goose - гусь
too - тоже
wolf - волк
tooth - зуб
teeth - зубы
catch - ловить
wood - лес
grey - серый
tail - хвост
tub - ванна
nut - орех
puppy - щенок
stripe - полоса
together - вместе
guitar - гитара
but - но
only - только
ask - спрашивать
answer - отвечать
run - бегать
children - дети
house - дом
school - школа
bear - медведь
hare - заяц
chair - стул
pear - груша
squirrel - белочка
short - короткий
soft - мягкий
hop - скакать
every - каждый
evening - вечер
morning - утро
afternoon - день
heron - цапля
beatiful - красивый
grass - трава
think - думать
hole - норка
lucky - удачливый
dolphin - дельфин
elephant - слон
photo - фотография
garden - сад
letter - письмо
for - для
holiday - выходные
teacher - учитель
great - отличный
kitchen - кухня
team - команда
strong - сильный
stupid - глупый
all - все
carry - носить
heavy - тяжелый
quickly - быстро
study - учиться
salad - салат
usually - обычно
correctly - правильно
sometimes - иногда
same - одинаково
smell - запах
weak - слабый
expensive - дорогой
cheap - дешевый
rich - богатый
poor - бедный
more - более
less - менее
meet - встречать
boot - ботинок
important - важный
check - проверять
underline - подчеркивать
circle - круг
cross - пересекать
tick - галочка
quiz - тест
difference - разница
delicious - вкусный
enough - достаточно
everything - все
feel - чувствовать
believe - верить
trust - доверять
hope - надеяться
chart - таблица
things - вещи
guess - полагать
raise - поднимать
adress - адрес
mean - означать
married - женат
husband - муж
wife - жена
international - международный
airport - аэропорт
different - различный
famous - знаменитый
near - рядом
cover - крыша
hug - обнимать
lazy - ленивый
chores - дела
frown - хмуриться
feed - кормить
whose - чей
while - пока
before - до
above - выше
below - ниже
under - под
comb - расческа
diary - ежедневник
file - папка
lighter - зажигалка
lipstick - помада
magazine - журнал
purse - кошелек
stamps - марки
tissues - салфетки
sentence - предложения
shorts - шорты
success - успех
eternal - вечный
flame - огонь
meant - предполагается
belong - принадлежать
through - через
whole - весь
lonely - одинокий
vacaciones - каникулы
instructions - инструкции
pocket - карман
worry - беспокоиться
point - точка
just - только
can - мочь
trolleys - тележки
country - страна
necessary - необходимый
similiar - похожий
headphones - наушники
draw - рисовать
hamster - хомяк
sweets - сладости
shelves - полки
probably - возможно
approximately - приблизительно
exactly - точно
incredible - невероятный
terrible - ужасный
mouth - рот
neck - шея
leg - нога
free - свободный
behind - сзади
between - между
wear - носить
really - действительно
spoil - портить
hate - ненавидеть
still - еще
quiet - тихое
south - юг
north - север
west - запад
east - восток
cartoons - мультфильмы
scientific - научный
hurry - торопиться
band - группа
constant - постоянный
hairdresser - парикмахер
waiter - официант
retired - пенсионер
lawyer - судья
stressful - напряженная
earn - зарабатывать
trip - поездка
brush - чистить
wash - мыть
face - лицо
sharp - острый
knife - нож
breakfast - завтрак
dinner - обед
supper - ужин